accounting: 경리, 회계 (업무), 회계(학)
candidate: 후보자, 후보생, 지원자
deserve: 받을 자격[가치]이 있다,~할 만하다
delay: 지연, 지체, 연기; 지연시키다
absence: 결근, 결석, 부재
surface: 표면, 외관
application: 응용, 적용, 신청
fascinate: 매료시키다, 마음을 사로잡다
flexible: 신축성 있는, 유연한,융통성 있는
introductory: 입문의, 도입의, 소개의
pursue: 해 나가다, 추구하다,계속하다
attach: 첨부하다, 붙이다,애착을 갖게 하다
gratitude: 감사, 고마움
reference: 참조, 참고, 문의, 언급
specify: 명시하다,분명히[자세히] 말하다
blizzard: 눈보라 ; 눈보라 치다
vegetated: 초목이 있는
steep: 가파른, 급경사진
devastating: 엄청나게 충격적인,황폐시키는
shatter: 산산이 부수다, 파괴하다
stare: 빤히 쳐다보다, 응시하다; 빤히 쳐다보기, 응시
circumstance: 사정, 상황, 형편
thrilling: 짜릿한, 아주 신나는
innocent: 천진난만한, 순수한, 무죄의
spiral: 소용돌이 모양으로 움직이다,나선형의, 나선형
verbalize: 말로 표현하다
count: 중요하다, 계산하다,~을 믿다[의지하다]; 수, 계산
legendary: 전설적인
spectacular: 멋진, 장관을 이루는, 굉장한,극적인
admire: 감탄하다, 존경하다,칭송하다
charm: 매력, 마력
irrational: 비합리적인, 비이성적인
rugged: 다부지게 생긴, 울퉁불퉁한,기복이 심한
bury: 묻다, 매장하다, 숨기다
theory: 이론, 학설, 의견
cosmos: 우주
distinguished: 저명한, 유명한, 눈에 띄는,출중한
surround: 둘러싸다, 에워싸다
escape: 빠져나오다, 벗어나다,탈출하다 ; 벗어남, 탈출
generous: 후한, 너그러운, 관대한,푸짐한
indebted: 신세를 진, 채무가 있는
polish: 광택제 ; 다듬다,윤을 내다, 닦다
appropriate: 적절한, 적합한
inspection: 점검, 검사, 조사
rite: 관습, 의례, 관례
superficial: 무의미한, 피상적인
sin: 잘못, 죄(악), 과실
misguided: 잘못된, 오도된
offensive: 기분을 상하게 하는,공격적인
resentment: 분노, 적의, 분개
priest: 사제, 성직자
appearance: 외모, 겉보기, 출현
statement: 표현, 진술, 성명서
rotate: 선회하다, 회전시키다,교대하다
convenience: 편리, 편의
undue: 과도한, 지나친
conscious: 의식적인, 알고 있는
fuzzy: 애매한, 흐릿한, 솜털 모양의
rigid: 경직된, 엄격한
interpret: 해석하다, 이해하다,통역하다
measure: 척도, 대책, 조치 ; 측정하다,재다
statistical: 통계적인, 통계에 근거한
intend: 의도하다, 작정하다, 뜻하다
occupy: 차지하다, (마음을) 사로잡다,점유하다
wilderness: 야생, 황야, 버려진 땅
prescribe: 처방하다, 규정하다,지시하다
improve: 향상하다, 개선하다,개량하다
acoustically: 음향적으로, 청각적으로
preserve: 보존하다, 유지하다
waterproof: 방수의 ; 방수복
confront: 맞서다, 들이대다,대항하다, 직면하다
optimistic: 낙관적인, 낙천적인
persistence: 끈기, 고집, 지속
pessimism: 비관주의, 비관론
retreat: 후퇴, 물러남, 은둔 ;물러나다, 은둔하다
status: 지위, 상태, 사정
attain: 얻다, 달성하다, ~에 달하다
distorted: 왜곡된, 일그러진, 비뚤어진
lottery: 복권, 추첨
scarce: 희귀한, 부족한, 드문
assure: 확신시키다, 보증하다, 보장하다
conflict: 갈등, 충돌, 대립; 충돌하다, 모순되다
consequence: 결과, 중요함, 영향
challenge: 난제, 도전 ; 도전하다
purchase: 구매, 구입 ; 구매하다,구입하다
asset: 자산, 재산, 유용한 자질
drastically: 급격히, 철저하게
workforce: 노동 인구, 노동력
desperate: 필사적인, 절망적인,자포자기의
isolate: 격리하다, 고립시키다
keen: 명민한, 열망하는, 예리한
predation: 포식, 약탈
remote: 외딴, 원격의, 먼 곳의
translocate: 이동시키다, 위치를 바꾸다
eagerness: 열망, 열의, 열심
enlist: ~의 도움을 받다, 입대하다
fulfilling: 성취감을 주는
identity: 정체성, 동일함, 독자성
purposeful: 목적이 있는, 의미심장한
resourceful: (문제 해결을 위해) 유용한,지략이 있는, 자원이 풍부한
signify: 나타내다, 의미하다
urge: 욕구, 충동 ; 강요하다,재촉하다
validate: (정당성을) 입증하다,인증하다, 승인하다
victimize: 피해자로 만들다, 희생시키다
adopt: 채택하다, 취하다, 입양하다
compromise: 양보하다, 절충하다,손상시키다 ; 양보, 타협, 절충
involve: 관련[연루]시키다, 포함하다
negotiate: 협상하다, 교섭하다
generation: 세대, 발생, 생성
respectively: 각각, 각자
sector: 분야, 부문, 영역
textile: (pl,) 섬유 산업, 직물
comprise: 차지하다, 구성하다
destination: 행선지, 목적지, 도착지
track: 추적하다; 선로, 진로, 길,자국
diploma: 졸업 증서
illustrate: 삽화를 그리다,(분명히)보여 주다, 예증하다
subsequently: 그 뒤에, 나중에
shelter: 피신하다 쉼터, 은신처,대피소
breed: 번식하다, 새끼를 낳다,기르다 ; 품종
freeze: 얼어붙다, 움직이지 않다
hierarchy: 서열, 계급, 위계
pregnant: 새끼를 가진[밴], 임신한
restrict: 한정하다, 제한하다,방해하다
loosen: 풀다, 느슨하게 하다
resume: 다시 시작하다, 되찾다; 이력서
collection: 소장품, 수집(품)
estate: 토지, 단지, 사유지
interval: 시기, 간격
foster: 키우다, 촉진하다, 조성하다
reside: 살다, 거주하다
device: 고안품, 기기, 기계 장치
mechanism: 기계 장치, 기제, 구조
patent: 특허를 받다; 특허(권)
productivity: 생산성
unique: 독특한, 특유의, 고유의
distribute: 분배하다, 배포하다,유통시키다
donation: 기부, 기증(품)
nonperishable: 잘 상하지 않는,보존할 수 있는
overdue: (지불, 반납 등의)기한이 지난
handy: 편리한, 유용한,손재주가 있는
brilliance: 탁월함, 화려함, 훌륭함
imprisonment: 수감, 투옥
prejudice: 편견을 갖게 하다,편견, 선입관
transform: 완전히 바꾸다, 변형시키다
approximately: 거의, 대략, 대체로
heartfelt: 마음에서 우러난, 진심 어린
sacred: 성스러운, 종교적인
determine: 결정하다, 알아내다,밝히다
prioritize: 우선적으로 처리하다,우선순위를 매기다
wonder: 궁금해하다, ~이 아닐까 생각하다 ; 경이, 놀라움, 불가사의
conceive: (생각, 감정을) 품다,생각하다, 상상하다, 고안하다
imitation: 모방, 모조품
intuition: 직관(력), 직감
commonplace: 아주 흔한, 평범한, 진부한
trim: 줄이다, 잘라 내다, 손질하다
factor: 요인
contestant: 참가자, 경쟁자
fantasy: 공상의 세계, 공상, 환상
alien: 외계의, 외국의, 이질적인;외계인, 외국인
minimally: 최소한으로, 최소로
enliven: 더 생동감 있게[재미있게]만들다
empathize: 공감하다, 감정 이입을 하다
persuasion: 설득
craft: 공들여 만들다, 공예품을만들다 ; 기교, 공예, 기술
cohesive: 단결된, 화합하는, 결합하는
consensus: 합의, 의견 일치
contrary: 반대; ~와는 반대되는
deviate: 벗어나다, 빗나가다
discord: 의견 충돌, 다툼, 불화
enormous: 엄청난, 막대한, 거대한
exclusion: 배척, 배제, 제외
relevance: 적합성, 타당성, 관련성
habitat: 서식지
meadow: 목초지, 풀밭
regulate: 조절하다, 통제하다, 규제하다
vibration: 진동, 떨림, 울림
corporation: 회사, 기업, 법인
irresistible: 저항할[억누를] 수 없는,거부할 수 없는
rebellion: 반란, 저항
secure: 보장되는, 안전한 ;확고히 하다
precise: 정확한, 정밀한
profound: 깊이 있는, 지대한, 심오한
quantify: 수량화하다, 양을 재다
exotic: 외래의, 이국적인
perceptible: 인지할 수 있는,지각할 수 있는
stock: 축적, 저장, 주식, 재고품
vivid: 생생한, 선명한, 활발한
hardwired: (능력, 자질 등이) 타고나는,고유한
inherit: 타고나다, 물려받다
innate: 타고난, 선천적인, 내재적인
ally: 동맹(국), 연합국, 협력자 ;동맹하다, 결합시키다
crisis: 위기, 고비, 난국
disturbing: 충격적인, 방해가 되는,불안감을 주는
intriguingly: 흥미롭게,호기심을 자극하면서
corpse: 시체, 송장
dehydrate: 수분을 제거하다,건조시키다
elaborate: 공들인, 정교한 ;공들여 만들다, 설명하다
potential: 잠재력, 가능성; 잠재적인,가능한
obsess: (마음을) 사로잡다,강박관념을 갖게 하다
steer: 이끌다, 조종하다
celebrated: 유명한
noticeable: 현저한, 두드러진,주목할 만한
vanish: 사라지다, 없어지다
carpenter: 목수, 목공
trot: (말을 타고) 속보로 가다,빨리 걷다
miser: 구두쇠, 수전노
domestic: 국내의, 가정의
dynasty: 왕조
resign: 사임하다, 물러나다, 물려주다,체념하다
vomit: 토하다
activate: 활성화하다, 작동시키다
evaluate: 평가하다, 감정하다
likelihood: 가능성, 있음직한 일
instinct: 본능, 천성
pose: 제기하다, 자세를 취하다;자세, 포즈
distraction: 마음을 산만하게 하는 것,오락거리
prolificacy: 다작으로, 다산으로
punctuate: 간간이 끼워 넣다,구두점을 찍다
stillness: 고요함, 정적, 정지
entail: 수반하다, 필요로 하다
resolve: 결심 ; 해결하다, 다짐하다,용해하다
anonymous: 익명의
consult: 충고를 구하다, 상의하다,진찰을 받다
mythology: 신화, 근거 없는 통념
respondent: 응답자
wage: (전쟁, 전투 등을) 벌이다 ;임금, 급료
barrier: 장벽, 장애물
bias: 편견, 편향 ;편견을 갖게 하다
personify: 의인화하다, 인격화하다
predominance: 지배, (수, 양적인) 우위[우세]
civic: 시민의, 시의
integral: 필수적인, 완전한
legitimately: 합법적으로, 정당하게
reclaim: 되찾다, 개간[간척]하다
confine: 가두다, 한정하다, 제한하다
rehabilitate: 복귀시키다, 재건하다,재활 치료를 하다
indefinitely: 무기한으로, 불명확하게
span: (얼마의 기간에) 걸치다 ;시간, 기간, 폭, 범위
underlying: 근원[근본]적인,밑[기저]에 있는
deem: ~라고 생각하다[여기다]
fabrication: 구조물, 제조, 제작, 구성
assign: 배치하다, 부여하다, 배정하다
momentary: 매 순간의, 순간적인,일시적인
perform: 수행하다, 실행하다, 공연하다
peer: 동료, 또래
policy: 정책, 방침
resolution: 해결(책), 결심, 해상도
antibody: 항체
vulnerability: 취약성, 상처받기 쉬움
patron: 후원자, 고객, 보호자
inferior: 지위가 낮은 사람, 아랫사람 ;손아래의, 질 낮은, 열등한
nobility: 귀족, 고결함, 고귀함
privilege: 특권, 특혜 ;특권[특혜]을 주다
impairment: 장애, 손상
restrain: 억제하다, 제한하다
stroke: 뇌졸중, 발작, 타격
conversion: 전환, 변환
proximity: 근접(성), 가까움
adequately: 제대로, 적절하게, 충분히
genuine: 진정한, 진짜의
auditory: 청각의
variable: 변하기 쉬운 것 ;변하기 쉬운, 가변성의
vowel: 모음의 ; 모음
disposal: 처리, 처분
extraction: 추출, 뽑아냄
immobilize: 고정시키다,움직이지 못하게 하다
radioactive: 방사성의, 방사능의
aspect: 측면, 양상, 국면
numerous: 수많은, 다수의
particle: 미립자, 극소량
accidental: 우연한, 우발적인, 뜻밖의
reinforce: 강화하다, 보강하다
superstition: 미신
category: 범주, 분야
criterion: 기준 (pl, criteria), 표준, 규준
notion: 개념, 생각, 관념
hostility: 적대(감), 적개심
revitalize: 새로운 활력을 주다,재활성화 시키다
reject: 거부하다, 거절하다
autopilot: 자동 조정, 자동 조종 장치
colony: (생물의) 군집, 식민지
drift: 흘러 다니다, 떠돌아다니다 ;흐름, 이동, 표류
resist: 저항하다, 반대하다, 견디다
dissolve: 용해되다, 녹다, 해산시키다
mixture: 혼합(물)
nitrogen: 질소
commission: 위원회, 작위, 위탁, 수수료
preventive: 예방의, 방지하는
solid: 고체, 고형물 ; 고체의,견고한, 단단한
cohere: 응집하다, 일관성이 있다
elastic: 탄력(성)이 있는
vessel: 용기, 그릇, 배, 혈관, 도관
comprehensive: 완전한, 종합적인, 포괄적인
straightforward: 간단한, 쉬운, 솔직한
browse: (잎 등을) 뜯어 먹다,둘러보다, 훑어보다
heal: 치료하다, 치유하다
simulate: 모의 실험하다, 가장하다
descend: 유래하다, 내려오다, 하강하다
linguist: 언어학자
fuss: 소란, 법석, 호들갑
constitute: 구성하다, ~이 되다
controversy: 논쟁, 논란
inventory: 목록, 재고
sponsorship: (재정적) 후원[협찬]
suspend: 유보[유예]하다, 중단하다,매달다
chunk: 덩어리, 두꺼운 조각 ;덩어리로 나누다
feat: 공적, 재주, 묘기
glance: 흘낏 보다; 흘낏봄
randomly: 무작위로, 임의로
alert: 방심하지 않는, 정신을 바짝차린, 경계하는 ; 경고하다
compel: ~하게 만들다, 강제[강요]하다
fade: 약해지다, 사라지다,희미해지다
immature: 미성숙한, 미완성의
complementary: 보완적인, 보충하는
obligation: 의무, 책임
ridicule: 조롱, 조소, 비웃음 ;조롱하다, 비웃다
grasp: 움켜잡다, 꽉 잡다, 이해하다,파악하다 ; 잡기, 이해, 파악
growl: 으르렁거리는 소리 ;으르렁거리다
offspring: 새끼, 자손, 후손
portrayal: 묘사
burglar: 강도, 도둑
compassion: 연민, 동정
confusion: 혼란, 당혹, 혼동
monk: 수도사, 수도승
sentence: (형을) 선고하다 ; 문장, 형벌,선고
welfare: 복지, 안녕, 행복
contempt: 경멸, 멸시
groom: 손질하다, 돌보다, 치장하다 ;신랑
rooster: 수탉
verse: 시, 운문
customs: 세관, 관세
reform: 개혁 ; 개혁하다
ownership: 소유 (권)
bore: (구멍을)파다[뚫다], 지루하게만들다 ; 지루한 사람[일]
construct: 만들다, 건조하다, 건설하다 ;구성 (개념)
blade: 칼날, 날
target: 표적으로 삼다, 목표로 삼다 ;표적, 과녁, 목표
discrepancy: 차이, 불일치, 모순
correct: 바로잡다, 정정하다;정확한, 올바른
dismiss: 해고하다, 묵살하다,해산시키다
astonishment: 놀람, 경악, 놀라운 것
allergic: 몹시 싫어하는,알레르기가 있는
nod: 끄덕이다, 꾸벅꾸벅하다 ;(고개를) 끄덕임, 졸음
agricultural: 농경의, 농업의, 농사의
gather: 채집하다, 모으다
relatively: 비교적
settle: 정착하다, 자리를 잡다,해결하다
plot: 작은 땅 (조각),(극,소설 따위의) 줄거리, 음모
domesticate: 사육하다, 재배하다
marginal: 변두리의, 주변의,주류에 속하지 않는
fundamental: 근본적인, 기본적인
formulate: 만들어 내다, 형성하다,명확히 말하다
proof: 증거, 증명
framework: 체계, 틀
rational: 합리적인, 이성적인
domain: 영역, 범위
pressure: 압력, 압박
primitive: 원시적인
heritage: 유산, 전통
innovation: 혁신(적인 것)
affluent: 부유한
landscape: 지형, 풍경(화)
inscribe: 새기다, 증정[헌정]하다
trace: 흔적, 극미량, 조금; 선을 긋다[그리다], 기록, 추적하다
illumination: 조명, (불)빛, 깨달음
discipline: 학문, 지식 분야, 규율;훈육하다, 징계하다
optical: 광학의, 시각적인
disaster: 재난, 재해
sink: 가라앉다 ; (부엌의) 싱크대,개수대
equator: 적도
freshwater: 민물, 민물의, 민물에 사는
keystone: 핵심, 중추, 중심
vegetation: 초목, 식물
enrich: 비옥하게 하다, 풍요롭게하다, 질을 높이다
obstacle: 장애 (물)
vast: 엄청난, 어마어마한
chaos: 혼란, 혼돈
meteor: 유성, 별똥별
acidify: 산성화하다
skeleton: 골격, 해골
extinct: 멸종된, 사라진
imprint: 흔적, 각인 ; 새기다,각인시키다
fossil: 화석, 시대에 뒤진 사람[것]
reflect: 반사하다, 반영하다,심사숙고하다
aesthetic: 미적인, 미학의,심미적인 ; 미학적 특질
integrate: 통합되다, 통합하다
merge: 어우러지다, 융합되다,합병하다
transparent: 투명한, 명백한, 명료한
assumption: 추정, 가정
narrative: 이야기, 서술, 묘사
complicated: 복잡한
fallacy: 오류, 그릇된 생각
temperature: 온도, 기온, 체온
substantial: 상당한, 실질적인
spontaneous: 즉흥적인, 자발적인
refrigeration: 냉동 (보존), 냉장, 냉각
remarkable: 놀라운, 현저한, 주목할만한
pneumonia: 폐렴
undergo: (영향, 변화, 검사 등) 받다,(시련 등을) 겪다[경험하다]
estimate: 추정(치), 추산 ; 가늠하다,추정하다
resource: 자원, 자료, 재료, 지략, 소질
novel: 새로운; 소설
flee: 달아나다, 도망가다
deprive: 빼앗다, 박탈하다
replicate: 복제하다, 반복하다 ;복제; 반복되는
captivity: 포획, 감금
disadvantage: 약점, 불리한 점 ;불리하게 하다
allotment: 배분, 배당, 할당
present: 일으키다, 주다, 제시하다 ;현재의, 참석한 ; 현재, 선물
establish: 설정하다, 설립하다, 규명하다,확고히 하다
extraordinary: 엄청난, 비범한, 놀라운
frequency: 주파수, 빈도
linear: (직)선의, 직접적인
compress: 압축하다 ; 압착 기계,압박 붕대
radical: 혁명적인, 급진적인, 기초적인
formula: 공식, 제조[조제]법
diminish: 감소시키다, 줄이다, 줄어들다
sophisticated: 정교한, 세련된
conservation: 보존, 보호
expansive: 널찍한, 탁 트인, 광활한,광범위한
attraction: 명소, 인기를 끄는 것,매력, 끌어당김
landmark: 명소, 주요 지형지물,획기적 사건
grave: 무덤; 심각한
archive: 기록 보관소 ;기록 보관소에 보관하다
uncover: 발견하다, 밝히다,덮개를 벗기다
institution: 기관, 단체, 제도
odds: 역경, 곤란, 가능성
nurture: 키우다, 육성하다 ; 양육, 양성
harbor: 숨겨 주다, (계획 생각 등을)품다 ; 항구, 은신처
similarity: 비슷함, 닮음, 유사(성)
prospective: 장래의, 미래의
charitable: 자비로운, 자선(단체)의,자선을 베푸는
mess: 엉망(인 상태), 어수선함, 혼란
neglect: 소홀히 하다, 무시하다 ;방치, 소홀
existence: 생활, 존재, 생존
commitment: 헌신, 전념, 약속
ritual: 의식적인 행사, 의식, 의례 ;의식상의, 의례의
immigration:' 이민, 이민자, 출입국관리(소)
envision: 구상하다, 마음속에 그리다
urgent: 절박한, 긴급한
correlation: 상관관계： 상호관계, 연관성
universal: 보편적인, 일반적인,전 세계적인
administration: 행정[관리] (업무), 행정 기관,집행
conduct: 수행하다, 실시하다, 지휘하다,(열, 전기를) 전도하다
access: 이용하다, 접근하다 ;이용, 접근
provision: 제공, 공급, 준비, 법률조항 ;(식량을) 공급하다
democratize: 민주화하다
align: 맞추다, 조정하다, 조정되다
autonomous: 자율의, 자율적인, 자치의
attachment: 애착, 부착, 부가(물)
intimate: 사적인, 친밀한
disrupt: 지장을 주다, 방해하다
leak: (기밀) 유출, 새는 곳[구멍, 틈]; 유출하다, 새다
invasion: 침해, 침공, 침략, 쇄도
delete: 삭제하다
footprint: 흔적, 발자국
favorable: 호의적인, 찬성하는, 유리한
motivate: 동기를 부여하다
embarrassment: 수치, 곤혹, 골칫거리,쑥스러움
vitality: 활력, 생명력
prophecy: 예언, 예언 능력
contagious: 전염성이 있는, 전염되는
direction: 방향, 지시, 감독, 연출
gorgeous: 멋진, 화려한, 매력적인
craftsmanship: (훌륭한) 솜씨, 손재주, 기교
elicit: (정보, 반응 등을) 끌어내다
defensive: 방어적인, 방어의, 수비의
constrain: 제한하다, 가두다, 강요하다
accuse: 비난하다, 고발[고소]하다
destructive: 파괴적인, 해로운
defeat: 패배 ; 물리치다, 이기다
constant: 지속적인, 일정한, 불변의
exaggerated: 과장된, 부풀린, 지나친
aide: 보좌관
representative: 대표(자), 대리인; 대의제의,대표하는, 전형적인
oppose: 반대하다
transnational: 다국적의, 초국가적인
empower: 권한[능력]을 부여하다,자율권을 주다
unleash: 자유롭게 하다, 속박을 풀다,촉발시키다
erode: 약화시키다, 떨어뜨리다,침식하다
alienation: 소외, 멀리함, 이간
longevity: 장수, 오랜 지속
process: 과정, 절차, 공정 ; 처리하다,가공하다
context: 상황, 환경, 맥락, 전후 사정
nutrition: 영양(물)
alternative: 대안, 대체; 대안의,대체의, 대안적인
insight: 통찰(력), 이해, 간파
subtle: 미묘한, 감지하기 힘든,교묘한
supplement: 보충제, 추가물 ; 보충하다,보완하다, 추가하다
zoologist: 동물학자
epidemic: 전염병, 급속한 확산
hinder: 막다, 저해하다, 방해하다
swallow: 삼키다, 마시다, (감정을)억누르다 ; 삼키기, 제비
hygiene: 위생 (상태), 위생법
grant: 주다, 허가하다 ; 보조금, 허가
panic: 공포, 허둥지둥함 ; 공황을일으키게 하다, 당황케 하다
grin: 씩[싱긋] 웃음 ; 씩 웃다,싱글거리다
selection: 선택, 선발, 선정, 선택된 것
internalize: 내면화하다,자기 것으로 만들다
ensure: 확실히 하다, 보장하다
redundant: 반복 되어서 불필요한,여분의, 감원 조치된
guarantee: 보장하다 , 보장, 담보,보증(서)
hesitate: 주저하다, 망설이다
foundation: 지, 토대, 기초, 재단
dominate: 지배하다, 통제하다,우위를 차지하다
intimidate: 겁을 주다, 협박[위협]하다
organism: 생물, 유기체
interdependent: 상호의존적인
indicator: 지표, 계기, 표시
absorb: 흡수하다, 빨아들이다,빠지게 만들다
sensitive: 민감한, 세심한
excessive: 과도한
chimney: 굴뚝
facility: 시설, 편의, 편리
frequent: 오 잦은, 빈번한
biodiversity: 생물 다양성
restore: 회복하다, 복원하다
encounter: 마주치다 , 마주침,(예상 밖의) 만남
intention: 의도, 목적
client: 고객, 의뢰인
slope: (산)비탈, 경사면, 경사지다,기울어지다
mismatch: 부조화 ,잘못 짝 지우다
akin: 비슷한, 유사한 ; 혈족
incorporate: 포함하다, 통합하다,설립[창립]하다
disease: 질병, 질환
boost: 증가시키다, 북돋우다 ,증가, 격려, 부양책
strategic: 전략적인
fluid: 유동적인 , 유체, 유동체,(동물의) 체액
publish: 출간하다, 출판하다, 발표하다
dedicated: 헌신적인, 전념하는, 전용의
expertise: 전문 지식
shortcut: 손쉬운 방법, 지름길
suspect: 용의자 , 의심하다
empire: 제국, 거대 기업
surplus: 잉여의, 과잉의 , 잉여, 과잉,혹자
marginalize: 무시[과소평가]하다,하찮은 존재로 만들다
capacity: 능력, 용량, 수용력
crucial: 중요한, 결정적인
ecology: 생태, 생태 환경, 생태학
reveal: 드러내다, 밝히다, 폭로하다
minimize: 최소화하다, 축소하다
inhibit: 방해하다, 억제[저해]하다,못하게 막다
threaten: 위협하다
approved: 승인된, 공인된
pronoun: 대명사
masculine: 남성의, 남자다운
distinctive: 독특한, 특이한
underdog: 약자, 약체, 질 것 같은 사람
cognition: 인식, 인지
encode: 부호화하다, 암호로 바꾸다
composition: 작품, 구성, 작곡, 작문
awesome: 굉장한, 근사한
arbitrary: 임의의, 자의적인, 제멋대로인
abstract: 추상적인
phrase: 구, 구절, 말 , 말로 표현하다
empirical: 경험적인, 경험에 의거한,실증적인
digest: 소화하다 , 요약, 개요
hypothesis: 가설 , 추정, 추측
crawl: 기어가다, (엎드려) 기다
umpire: 심판 , 심판을 보다
maintenance: 관리, 유지
additional: 추가의, 추가적인
squeeze: 꽉 쥐다, 끼워 넣다, 압착하다, 압착, 짜내기
semester: 학기
essence: 핵심, 본질,(추출한) 에센스, 진액
dimension: 영역, 차원, 크기, 관점
interrupt: 방해하다, 가로막다
omit: 생략하다, 빠뜨리다, 누락하다
cease: 그만두다, 중단하다
prose: 산문(체), 산문 작품
clarify: 명확하게 하다,분명히 말하다
renewal: 재생, 부흥, 갱신
progressive: 진보적인, 점진적인
artificial: 인공의, 인위적인
resident: 주민, 거주자,사는, 거주하는
vague: 모호한, 희미한
appointment: 약속, 예약, 임명, 지명
gradation: 단계적 변화[차이]
blend: 뒤섞이다, 혼합물
retain: 유지하다, 보유하다
presence: 있음, 존재(함), 참석
reservoir: 저장고, 저수지, 비축
spot: 찾아내다, 알아채다,자리, 장소, 반점
solitary: 혼자 하는, 외딴
territory: 지역, 영역, 영토
advent: 도래, 출현
manual: 손의, 육체를 쓰는,안내서, 취급 설명서
deficiency: 결함, 결점, 결핍(증)
limitation: 한계, 제한, 제약, 규제
logical: 논리적인, 타당한
thriving: 번영하는, 번창하는
component: 부품, (구성) 요소
atmosphere: 공기, 대기, 분위기
circulate: 유포하다, 순환시키다
primate: 영장류
yield: 만들어 내다, 양보하다,항복하다, 수확(량), 총 수익
authority: 당국, 권위, 권한
designate: 지정하다, 지명하다
reputation: 명성, 평판
crash: 고장 내다, 추락하다,충돌하다 , 추락, 충돌
justify: 정당화하다
endure: 견디다, 감내하다, 오래가다
unfold: 펼쳐지다, 발생하다, 나타나다
scattered: 산발적인, 흩어져 있는,드문드문 있는
spark: 불러일으키다, 촉발[유발]하다,불꽃, 불똥
medieval: 중세의, 중세적인
notify: 통지하다, 알리다, 신고하다
funeral: 장례식, 영결식
burial: 매장
coordinate: 조정하다, 조직화하다 ,좌표, 동등한 사람[것]
molecular: 분자의, 분자로 된
discard: 버리다, 폐기하다
anecdote: 일화
abound: 넘쳐나다, 아주 많다
prolong: 연장하다
summons: 호출, 소환(장)
aggression: 공격(성)
refined: 정밀한, 정제된, 세련된
anatomy: (해부학적) 구조, 해부(학)
injury: 부상, 손해, 손상
disclosure: 누설, 폭로, 노출
mislead: 오도하다, 잘못 이끌다
volcano: 화산
lure: 유혹하다, 꾀다, 유혹(물),매력
perish: 죽다, 소멸되다
headquarters: 본사, 본부
compatible: 합치하는, 양립할 수 있는
accuracy: 정확(성)
declare: 선언하다, 단언하다,(소득 과세품 등을) 신고하다
assessment: 평가
persist: 계속 존재하다, 남아 있다
document: 문서, 기록
customary: 관습적인, 관례의
illusion: 환상, 착각
idealize: 이상화하다, 이상형으로 삼다
self:-esteem 자존감, 자아 존중감
corresponding: 상응하는
outdo: 능가하다, 앞지르다
divine: 신의, 신성한
admirable: 존경스러운, 감탄할 만한
contentment: 만족, 자족
fable: 꾸며 낸 이야기, 우화
string: 현, 줄
wind: 감다
realm: 영역, 분야, 부분
vigorous: 활발한, 격렬한, 원기 왕성한
depict: 표현하다, 묘사하다
passion: 열정
impact: 영향을 미치다 , 영향
inevitable: 필연적인, 불가피한
outcome: 결과
alter: 바꾸다
efficiency: 효율성
manifestation: 발현, 명시, 징후, 나타남
convention: 관습, 관행
individualistic: 개인주의적인
distress: 고통
handle: 다스리다, 처리하다, 다루다
kidney: 신장
fireplace: 벽난로
mobile: 이동성이 있는, 이동하는
permanently: 영구적으로, 영구히
conscience: 양심
neon: 네온 빛의, 네온의
glimpse: 언뜻 봄, 잠깐 봄, 얼핏 봄
interstate: [주와 주 사이의] 고속도로,국가 간의
assert: 주장하다
extreme: 극단적인, 매우 격한
innumerable: 수없이 많은, 무수한
fiction: 허구, 공상, 꾸민 이야기
problematic: 문제가 되는, 문제가 많은
region: 지역, 지방
standard: 표준, 기준
adolescence: 청소년기, 사춘기
inescapable: 피할 수 없는
discharge: 배출하다, 내보내다
refrain: 반복되는 말, 흔히 하는 말,후렴; 그만두다, 삼가다
nastiness: 심술궂음, 악의
fatigue: 피로
prompt: 자극하다, 유도하다 신속한
suppress: 억누르다, 억압하다
abnormal: 비정상적인
descent: 가계, 혈통, 하강
species: (생물의) 종
resistance: 저항(력)
outline: 윤곽 , 약술하다
prior: 이전의, 사전의
consistent: 일관된, 일치하는, 한결같은
guideline: 지침
inclination: 경향, 좋아하는 것, 성향,기울기
transition: 전환
inflexible: 경직된, 융통성 없는
ironic: 모순적인, 역설적인, 반어적인
overlap: 겹치다, 중복되다
facilitate: 촉진하다, 조장하다
astronomy: 천문학
contemplate: 깊이 생각하다, 고려하다
appreciate: 감사하다, 음미하다, 감상하다
critical: 결정적인, 중요한, 중대한
fake: 꾸며 내다, ~인 체하다 ,허위의 , 모조품
causative: 원인이 되는, 일으키는
determinism: 결정론
compact: 조밀한, 좁은, 작은
leafy: 나무가 많은, 잎이 무성한
precious: 귀중한, 소중한
gene: 유전자
origin: 근원, 기원
symptom: 증상
competition: 경쟁
implication: 영향, 함의, 결과
prosperity: 번영
merit: 가치, 장점
overload: 과부하 ,과부하가 걸리게 하다
breakthrough: 돌파구, 획기적인 진전
recite: 읊다, 낭송하다
vulnerable: 상처받기 쉬운, 취약한
progress: 진척 , 진척되다, 발전하다
core: 핵심적인 핵심
implicit: 암묵적인, 내재[잠재]하는
initial: 처음의
utterly: 전혀, 아주, 완전히
match: 상대, 적수, 시합
trickery: 속임수, 술수, 책략
figure: 수치, 숫자, 인사, 인물
expert: 전문가
fingering: 운지법(악기를 연주할 때손가락을 쓰는 방법)
engagement: 참여, 약혼
moderate: 적절한, 중간 정도의
sequence: 연속(물)
abundant: 많은, 풍부한
evaporation: 증발
transport: 운반, 수송 , 운반하다,수송하다
financial: 금전적인, 재정적인, 금융상의
overlook: 간과하다
prevalent: 일반적인, 우세한, 유력한
requirement: 요구 사항, 요건, 필요(량)
bureaucratic: 분권화하다
decentralize: 분권화하다
delegate: 위임하다, 대표로 보내다
firm: 희사 , 굳은, 단단한, 견고한
morale: 사기
adherence: 고수, 집착, 부착
lamb: 어린 양, 양고기
parable: 비유, 우화
empathetic: 공감할 수 있는, 감정 이입의
intuitive: 직관적인
kin: 친족, 일가
civilian: 민간의, 민간인
dismissal: 퇴학, 해고
faculty: 교수진, 능력
impose: 부과하다, 지우다, 강요하다
temptation: 유혹
tolerate: 용인하다, 용납하다, 참다
embrace: 받아들이다, 포용하다
manufacturer: 제조업체, 제조업자
calculation: 계산
investment: 투자(액)
induce: 유발하다, 유도하다
meditation: 명상, 숙고
thrive: 번성하다, 잘 자라다,무성하다
operation: 수술, 운영
surgical: 수술상의, 외과의
incidentally: 우연히
intelligence: 지능, 지성
intertwine: 뒤얽다, 엮다
manipulate: 조작하다, 조종하다, 다루다
emphasis: 강조
navigate: 이동하여 다니다, 항해하다
reassure: 안심시키다, 재보증하다
wave: 손짓, 손 흔들기, 파도, 물결,파동 , 손을 흔들다
accelerate: 가속하다
journalist: 기자, 저널리스트
contemporary: 현대의, 동시대의
retail: 소매, 소매의
incentive: 동기, 자극, 자극적인
opponent: 반대자, 상대
multiply: 증식하다, 곱하다
shoot: 순, 싹, 사격, 발사 , (총 화살을) 쏘다, 발사하다, 촬영하다
collective: 집단의, 공동의
judge: 심사위원, 재판관, 판사 ,판정하다, 판단하다
sufficient: 충분한
metaphor: 은유, 비유
myth: 신화, 속설, 근거 없는 믿음
accomplishment: 성과, 성취, 업적
lapse: (시간의) 경과
competence: 능력, 자격, 역량
deplete: 고갈시키다
significance: 중요성, 유의미성
validity: 타당성
arise: 발생하다, 일어나다
far:-reaching 광범위한,(영향 등이) 멀리 미치는
phonograph: 축음기
predict: 예측하다
refrigerant: 식히는 (cooling), 얼게 하는, 냉각(냉동)제, 청량제(음료)
unforeseen: 예측하지 못한, 예상치 못한,뜻밖의
profile: 특징, 옆 모습, 개요, 윤곽
invariably: 언제나, 변함없이
prestigious: 명망 있는, 유명한
deteriorate: 나빠지다, 악화되다
prescription: 처방, 처방전
willingness: 의향, 자진해서 하는 마음,하려는 의지
concrete: 구체적인
confirm: (사실임을) 확인하다
generalized: 일반화된
dash: 서두르다, 돌진하다 ,돌진, 질주
incidence: 발생률, 발병률
literacy: 능력, 지식, 문해력글을 읽고 쓸 줄 아는 능력
patch: 작은 땅, 구역, 안대
remedial: 개선의, 교정의, 치료상의
athlete: 육상 경기 선수, 운동선수
surefire: 확실한, 틀림없는
executive: 경영 간부, 집행의
aging: 노화, 고령화
forewing: (곤충의) 앞날개
mounted: (전시품을) 받침대로 받쳐놓은, (사진에) 대지를 붙인
migrate: 이주하다, 이동하다
console: (게임) 콘솔[제어 장치] ,위로하다
parenting: 육아, 양육
relief: 구호, 구호품, 완화, 경감
literature: 문학, 문헌
capability: 능력, 역량
contribution: 공헌, 기여, 기부금
normative: 규준과 연관된, 표준적인
principal: 주요한 , 교장, 학장, 총장
postpone: 연기하다, 미루다
risk: 위험, 위험 요인
dispute: 논쟁, 분쟁
literally: 문자 그대로, 말 그대로,그야말로
regime: 체제, 정권, 제도
gradually: 점차, 서서히
stiffness: 경직도, 뻣뻣한 정도, 뻣뻣함
transmit: 전달하다, 전파하다
ambitious: 야심찬
execute: 실행하다, 처리하다
bundle: 다발, 일단, 덩어리
evenly: 공평하게, 고르게
furious: 몹시 화가 난
harvest: 수확하다 , 수확
plow: 갈다, 경작하다, 쟁기 , 쟁기비슷한 것, 제설기
wheat: 밀
interfere: 방해하다, 간섭하다
coin: (새로운 용어를) 만들어 내다,화폐, 동전, 경화
adequate: 적절한, 충분한
reptile: 파충류
invasive: 급속히 퍼지는, 침습성의,(권리 따위를) 침해하는
infamous: 불명예스러운, 수치스러운,악명 높은
poll: 여론 조사 ,여론 조사를 하다
statistician: 통계 전문가, 통계학자
alliance: 제휴, 연합, 동맹
mediate: 조정하다, 중재하다
championship: 선수권 대회, 선수권
chill: 오싹한 느낌, 감기, 냉기
formally: 공식적으로
official: 심판, 공무원 , 공식적인
senior: 졸업반 학생, 상급생, 노년층
convince: 납득시키다, 확신시키다
offend: 불쾌하게 하다,기분 나쁘게 하다, 공격하다
considerable: 상당한
neutral: 중립적인
aggressor: (먼저) 공격한 사람, 공격자
nasty: 불쾌한, 해로운
resentful: 화가 난, 분개하는
admiration: 감탄, 존경, 우러러봄
return: 수익, 반납하다, 돌려주다
barefoot: 맨발의
eyebrow: 눈썹
pat: 쓰다듬다
shrug: 어깨를 으쓱하다
survive: 생존하다, 살아남다
trunk: (코끼리의) 코,(나무의) 줄기(몸통), 트렁크
awkward: 어색한
last-minute: 막바지의, 마지막 순간의
composer: 작곡가
exhausted: 동난, 다 써 버린, 몹시 지친
laundry: 세탁(물), 빨래, 세탁소
chemist: 화학자
explanation: 설명
harsh: 가혹한, 혹독한
customization: 주문 제작, 맞춤 제작
differentiate: 차별화하다, 구별하다
denial: 부정, 부인, 거부
former: 예전의, 전의
frustration: 좌절(감)
independent: 독립적인
self:-reliance 자립
fruitless: 성과 없는
sentiment: 정서, 감정
synonymous: 아주 밀접한, 동의어의
appetite: 욕구, 식욕
greed: 탐욕, 욕심
cautious: 신중한, 조심하는
emotive: 감정을 자극하는, 감정적인
portrait: 묘사, 초상, 초상화
misleading: 오도하는,오해의 소지가 있는
reversal: 반전, 전도, 번복
genius: 천재성, 천재
conceal: 숨기다, 감추다
plausible: 그럴듯한, 타당해 보이는
boundary: 경계(선), 한계
contamination: 오염
vehicle: 차량, 수단, 매개체
imagery: 심상, 화상, 이미지
undergraduate: 학부(생)의, 대학생의,학부생, 대학생
visualize: 마음속에 그리다, 시각화하다
boredom: 지루함
impair: 지장을 주다, 해를 입히다,손상하다
humanity: 인간의 속성, 인류, 인문학
integrity: 정직, 성실, 완전한 상태
impress: 인상을 남기다,깊은 인상을 주다
grace: 품위, 우아(함)
optimized: 최적화된
triumph: 승리 , 승리하다
familiarity: 익숙함, 친숙성, 친숙함
odorless: 냄새가 없는, 무취의
virtually: 거의, 사실상
landfill: 매립 쓰레기, 쓰레기 매립지
chore: (정기적으로 하는) 일, 잡일,하기 싫은 일
reluctantly: 마지못해
reminder: 상기시켜 주는 것,(잊지 않기 위한) 메모
utilitarian: 실용주의적인, 실리주의의
yearbook: 졸업 앨범, 연감
intonation: 억양
pinpoint: 정확하게 지적[묘사]하다
invisible: 보이지 않는
obscure: 이해하기 힘든, 알기 어려운,불분명한 , 흐리게 하다
wavelength: 파장
credible: 믿을 만한, 신뢰할 수 있는
governance: 관리, 관리 방식, 통치
pictogram: 그림문자
amazement: 깜짝 놀람, 망연자실
exclaim: 소리치다, 외치다
stumble: 발을 헛디디다, 발이 걸리다
stereotype: 고정 관념
therapist: 치료 전문가, 치료사
preschool: 유치원
involvement: 참여, 관계 맺기
readjust: 재조정하다, 재적응하다
genre: 장르
priority: 우선순위, 우선
intensify: 심화하다, 강화하다, 증대하다,늘리다
mutual: 상호 간의
sweep: 휩쓸다, 쓸다
intake: 섭취(량)
proportion: 비율
debt: 빚
ease: 덜다, 완화하다, 쉽게 하다 ;쉬움, 편안함
instrumental: 도움이 되는, 기악의, 악기의
delivery: 배달
submission: 제출, 제출물, 항복, 굴복
participation: 참가, 참여
accumulate: 축적하다, 모으다
cordial: 화기애애한, 다정한
determinant: 결정 요인
literary: 문학의, 문학적인
objective: 객관적인; 목표
script: 원고, 대본
imminent: 임박한, 절박한
lengthy: 지루한, 오랜
cynical: 냉소적인
reducible: (단순하게) 축소될 수 있는
causal: 인과의, 원인의
contract: (병에) 걸리다, 계약하다,수축하다, 줄어들다 ; 계약
pregnancy: 임신 (기간)
detective: 수사관, 형사, 탐정 ; 탐정의
external: 외부적인, 외부의
promote: 홍보하다, 장려하다, 촉구하다,승진시키다
genetics: 유전적 특징, 유전학
heritable: 유전성의, 유전하는,유전될 수 있는
retardation: 지체, 지연
eruption: 폭발, 분화
obtain: 얻다, 획득하다
coauthor: 공저자, 공동 집필자 ;공동 집필하다
nonexistent: 존재하지 않는
pesticide: 농약, 살충제
compliance: 따름, 준수
decent: 적당한, 제대로 된, 관대한
tedious: 지루한
by:-product 부산물
constituent: 성분, 구성물
cultured: 배양된, 재배된, 양식된
flesh: 살, 고기, 육체
banquet: 연회, 잔치
delicacy: 맛있는 것, 진미
faint: 희미한, 엷은
filthy: 더러운, 불결한
folly: 어리석음, 어리석은 짓
garment: 의복, 옷
guard: 경비병, 호위병, 문지기
proclamation: 포고, 포고문[령], 선언
content: 내용, 목차, 함유량 ; 만족한
prominent: 유명한, 저명한, 탁월한
drain: 배수관 ; 물이 빠지다
frighten: 두렵게 하다, 겁먹게 하다
sip: 한 모금 ; 조금씩 마시다,(음료를) 홀짝이다
adversity: 역경, 고난
overwhelmed: 어찌할 줄 모르는, 압도된
extensive: 광범위한, 넓은, 대규모의
layout: (책, 정원, 건물 등의) 배치,레이아웃
perception: 인식, 지각
brutalize: 흉악하게 만들다,잔인하게 만들다
implement: 실행하다, 이행하다
mystical: 신비주의의, 신령스러운
punishment: 처벌, 응징
pre:-owned 중고의
infant: 유아, 젖먹이; 젖먹이의,유아의, 소아의
mortality: 사망(자 수), 죽어야 할 운명
revise: 개정하다, 수정하다
substitute: 대체물, 대체품 ; 대체하다
eligible: 자격이 있는
nomination: 후보 추천, 후보에 오름,지명
adjust: 조정하다, 조절하다
intact: 온전한, 영향을 받지 않는
escalate: 확대[증가, 악화]되다,높이다, 올리다
conversation: 대화
conservative: 보수적인; 보수주의자
ingredient: (요리 등의) 재료, 성분
occasion: 계기, 행사,(어떤 일이 일어나는) 때
phenomenon: 현상
provoke: (특정한 반응을) 유발하다,화나게 하다
discomfort: 불편함, 불쾌감
pacifist: 평화주의자, 반전주의자
perspective: 관점, 원근법, 경치, 조망
comparative: 비교를 통한, 비교상의,비교의
disproportionately: 불균형적으로, 어울리지 않게
proliferation: 확산, 급증
unfit: 부적합한
anticipate: 예상하다, 기대하다
deficit: 부족, 결핍, 적자
optimal: 최적의
communal: 공동체의, 공동의
flickering: 깜박거리는
outright: 전면적인, 명백한
peasant: 농부, 소작농
premature: 성급한, 너무 이른
superficially: 피상적으로, 수박 겉핥기 식으로, 표면적으로
ancestor: 조상, 선조
equivalent: 상당하는 것, 등가물 ;같은, 상당하는
grab: 잡아채다, 붙잡다
trigger: 작동시키다, 촉발하다,발사하다 ; 방아쇠, 자극
analysis: 분석
friction: 마찰
intrinsic: 고유의, 내재적인, 본질적인
slippery: 미끄러운
eliminate: 없애다, 제거하다
promptness: 지각하지 않음, 신속함,민첩성
removal: 없애기, 제거
withhold: 주지 않다, 억제하다,보류하다
assistant: 조수, 보조원
emerge: 발생하다, 나오다, 출현하다
dynamic: 역학, 동력학; 역동적인, 활발한
overestimate: 과대평가하다
request: 요청, 요구 ; 요청하다,요구하다
commercial: 민간의, 민영의, 상업적인 ;광고 (방송)
halt: 멈추게 하다, 중단시키다,서다
install: 설치하다
reliable: 믿을 만한, 신뢰할 수 있는
existing: 기존의, 현재 사용되는
shipment: 운송, 수송(품), 선적
transportation: 운송, 수송, 교통 기관
drag: 끌어당기다
hatch: 승강구 ; 부화되다,(음모 따위를) 꾸미다
inject: 주입하다, 주사하다
previous: 이전의
procedure: 절차, 수순
submerge: 잠수하다, 물에 잠기다
terrified: 겁에 질린, 무서워하는
modernize: 현대화하다
strive: 노력하다, 분투하다, 애쓰다
sustain: 유지하다, 지속하다
command: 명령 ; 명령하다, 지휘하다
gaze: 바라보다, 응시하다
persuade: 설득하다
release: 석방, 출시, 개봉; 표출하다,풀어 주다, 공개하다
shiver: 전율, 몸서리 ; (몸을) 떨다
spine: 척추, 등뼈, 가시
enormity: 엄청남, 심각성, 대단함
athletic: 운동의, 체육의,(근육이) 강건한
rarity: 희귀한 것, 희소성
comprehension: 이해, 이해력, 포함, 함축
evolution: 진화, 발전
foe: 적
forbid: 금하다, 금지하다
paralyze: 마비시키다
swirl: 소용돌이치다, 빙빙 돌다 ;소용돌이
tailor: (옷을) 제작하다, 맞추다 ;재단사, 재봉사
outgrow: (옷 등이) 너무 커져 맞지않게 되다
raw: 날것의, 익히지 않은,가공하지 않은
starve: 굶주리다, 굶어 죽다,아사시키다
agribusiness: 기업식 농업,농업 관련 기업[사업]
attitude: 태도, 자세, 사고방식
breathe: 숨 쉬다, 호흡하다
deliberate: 고의적인, 신중한
foul: 더러운, 불결한 ;(스포츠에서) 파울
shortage: 부족, 결핍
visible: 눈에 보이는, 가시적인
discern: 인식하다, 파악하다, 분별하다
generate: 낳다, 생성하다, 발생시키다
platform: 플랫폼(기반이 되는 컴퓨터시스템) 승강장, 연단, 강단
post:-scientific 후기 과학 시대의
revolution: 혁명, 회전, 공전
surpass: 능가하다, 뛰어넘다
advocate: 지지자, 옹호자 ;옹호[지지]하다
psychoanalytic: 정신 분석학적인,정신 분석의
qualify: 자격을 얻다, 자격을 주다
trait: 특성, 이목구비, 형질
undertake: 시작하다, 착수하다
intensity: 강도, 세기
portable: 휴대가 쉬운, 휴대용의
separate: 별개의, 분리된 ; 분리하다,나누다, 헤어지다
diverse: 다양한
instruction: 설명, 지시, 교육
attribute: ~의 결과로 보다,~탓으로 돌리다; 자질, 속성
intellectual: 지적인, 지능의; 지식인, 식자
reasoning: 추론, 추리
computation: 계산, 컴퓨터의 사용
striking: 현저한, 두드러진
deception: 속임수, 기만
distinction: 구별, 차별, 뛰어남
anchor: 지주, 닻; ~에 기반을 두다,닻을 내리다, 정박하다
imperative: 책무, 원칙, 명령 ; 긴요한,반드시 해야 하는
project: 투영하다, 투사하다, 예상하다; 과제, 프로젝트
motive: 동기, 이유, (예술 작품의)주제, 제재
simultaneously: 동시에
trail: 흔적, 행적, 오솔길 ;끌다, 추적하다
acquire: 얻다, 습득하다, 획득하다
combination: 조합, (자물쇠의) 비밀번호
consumption: 소비, 소모
entrepreneur: 기업가, 사업가
afflict: 괴롭히다, 시달리게 하다
avoidance: 회피, 방지
impel: ~해야만 하게 하다, 강요하다,추진시키다
paradox: 역설, 자기모순의 말,역설적인 것
puzzle: 곤혹스럽게 하다, 당황케하다 ; 당황, 당혹, 수수께끼
utilize: 이용하다, 활용하다
twilight: 말기, 쇠퇴기, 땅거미, 황혼
array: 다수, 배열, 정렬, 집합체
authoritarian: 권위주의적인; 권위주의자
precedence: 우선(함), 선행
formative: 형성에 중요한,발달에 중요한
attract: 끌다, 유인하다, 매혹하다
momentous: 중대한
immense: 엄청난, 막대한, 어마어마한
profoundly: 깊이, 극심하게
midst: 중앙, 한가운데
stem: 줄기 ; 유래하다
confer: 부여하다, 주다
entity: 실체, 독립체
suicidally: 자살을 감수하여,자살 충동을 느껴
troop: 무리, 병력, 부대
dose: 양, (1 회분의) 복용량, 투여량
convey: 가져다 주다, 전달하다,운반하다
radiation: 방사선,(열, 에너지 등의) 복사
formidable: 매우 뛰어난, 굉장한, 무서운,어마어마한
inherently: 본질적으로
aspiration: 열망, 포부
proficiency: 능숙(함), 숙달
undermine: 약화시키다, 손상시키다
acknowledge: 인정하다, 승인하다
anthropologist: 인류학자
dietary: 음식의, 식이 요법의
contradict: 모순되다, 반박하다, 부인하다
proceed: 이어서 ~하다, 나아가다,진행하다
solemn: 엄숙한, 근엄한
anthem: 찬송가, 축가, 국가
collapse: 붕괴하다, 무너지다,(사업이)실패하다; 붕괴
heroine: (여자) 영웅, 여걸,(소설, 영화 등의) 여자주인공
resilience: 회복력, 탄력
roar: 함성을 지르다, 으르렁거리다
standstill: 정지, 멈춤
weed: 잡초 ; 제초하다
liquid: 액상의 ; 액체, 액상
cooperation: 협조, 협동
rescue: 구조하다 ; 구출, 구조
obvious: 분명한
crumple: 구기다, 쓰러지다
tear: 뜯다, 찢다 ; 눈물
recognize: 알아보다, 인식하다, 인정하다
relationship: 관계, 관련
bend: 구부리다, 굽히다, 숙이다;굽음, 굽은 곳
notice: 알아차리다, 통지하다 ;주목, 공고문
thrilled: 신이 난, 흥분한
stream: 흘러내리다 ; 개울, 시내
cockpit: 조종석[실]
adolescent: 청소년 ; 사춘기의, 청춘의
complete: 완수하다, 완성하다;완전한, 완료된
motivation: 동기 부여, 자극
expectation: 기대, 예상
directness: 솔직함, 단순 명쾌함
disreputable: 불명예스러운, 평판이 안 좋은
inexperienced: 경험이 없는, 미숙한
virtual: 가상의, 사실상의
benefit: 이익, 수당, 보조금;이익이 되다, 이롭다
cruelty: 잔학 행위, 학대, 잔인함
sensibility: 감정, 감수성
operate: 운영하다, 작동하다, 수술하다
humanely: 인도적으로
protest: 항의, 시위; 항의[반대]하다
maximize: 극대화하다, 최대화하다, 최대한 활용하다
copy: 복사하다, 따라하다 ; 복사[복제](본), (책, 신문 등의) 한 부
summary: 요약, 일람, 개요
intrude: 밀고 들어오다, 침해하다, 방해하다
ingest: 삼키다, 섭취하다, 받아들이다
submit: 제출하다, 항복[굴복]하다
drawback: 문제점, 결점
physiology: 생리 (기능), 생리학
observe: 관찰하다, 준수하다, 말하다
disability: 장애, 무능
planet: 행성, 지구
tumor: 종양
resort: 의지하다, 기대다 ;의지, 의존, 휴양지, 리조트
primary: 가장 중요한, 제 1 의, 초기의
monitor: 추적 관찰하다, 감시[모니터]하다 ; 감시 장치, 모니터
contribute: 기여하다, 이바지하다,(~의) 원인이 되다
setting: 환경, 장소, 배경, 설정
element: 요소, 성분
multiple: 다양한, 많은, 다수의
portray: 묘사하다, 그리다
purpose: 목적, 의도
conception: 개념, (계획 등의) 구상
conformity: 순응
agenda: 행동 강령, 의제, 일정, 계획
exclude: 배제하다, 제외하다, 거부하다
substance: 실체, 물질, 본질
victorious: 승리한, 승리를 거둔
destruction: 파괴, 말살
inflow: 유입
bankruptcy: 파산 (상태), 파탄
errand: 심부름
detailed: 상세한, 자세한
politics: 정치(학)
correspondent: 특파원, 통신원,편지를 주고받는 사람
uprising: 봉기, 반란
intensive: 집중적인, 집약적인, 격렬한
gymnast: 체조선수
rank: (등급 순위 등을) 차지하다 ;계급, 지위, 등급
relative: 친척; 상대적인, 관계 있는
intervention: 개입, 간섭
diameter: 지름, (렌즈의) 배율
cactus: 선인장
layer: 껍질, 막, 층, 겹
strip: 가느다란 조각 ; 뜯어내다,벗기다
grain: 곡물, 알갱이, 입자
deposit: 계약금, 보증금, 침전물 ; 예금[예치]하다, 쌓다, 퇴적시키다
celebrate: 기념하다, 축하하다
blink: (불빛이) 깜박이다,눈을 깜박이다 ; 눈을 깜박임
indicate: 보여 주다, 나타내다
placement: 반 편성, 배치
drainage: 배수 (시설)
prolonged: 장기적인, 오래 계속되는
division: 분배, 구분, 나누기
necessity: 불가피한 일, 필수품, 필요(성)
blackout: 정전, 일시적인 의식 상실
incident: 사건, 일
evaporate: 사라지다, 증발하다
launch: 시작[개시, 착수]하다,출시[출간]하다
bombard: 폭격하다, (비난 등을) 퍼붓다
essential: 본질적인, 필수적인
immerse: 몰두시키다,(액체 속에) 담그다
describe: 기술하다, 묘사하다
methodological: 방법론적인, 방법론의
so:-called 소위, 흔히 ~라고 일컬어지는
certification: 인증, 자격증, 증명(서)
signature: 서명, 특징
genuineness: 진품임, 진성, 진위
fabric: 구조, 직물, 천
geographical: 지리(학)적인, 지리(학)의
oppression: 억압, 압제
affair: 일, 문제, 사건
catering: 식품[음식]공급(업)
storage: 저장(고), 보관(소), 수납
coincide: 동시에 일어나다, 일치하다
purification: 정제, 정화
distillation: 증류, 증류물, 증류법
flour: 밀가루, 가루 ; 밀가루를바르다, ~에 가루를 뿌리다
vegetable: 채소, 야채, 식물
shrink: 줄어들다, 오그라들다,움츠리다
bystander: 행인, 구경꾼
discount: 경시하다, 할인하다, 할인
irrelevant: 관계가 없는, 무관한
burden: 부담, 짐
ideology: 이데올로기, 이념, 사상, 관념
consideration: 고려 (사항), 숙고
racism: 인종차별 (주의)
minority: 소수자, 소수 집단
virtue: 덕, 미덕, 장점
ultimate: 궁극적인
generalization: 귀납적 결과, 일반화
violate: 위배하다, 침해하다
elaboration: 정교화
instance: 사례, 경우
outweigh: 능가하다, 외보다 더 크다
infinite: 무한히 많은, 끝없는
impoverish: 가난하게 하다,질을 떨어뜨리다, 저하시키다
intricate: 복잡한
proclaim: 분명히 드러내다, 선언하다
tribal: 부족의, 종족의
concurrent: 동시(발생)의, 일치하는
specialized: 특화된, 전문화된
display: 과시, 전시, 진열 ,보여 주다, 전시하다
relay: 전달하다, 중계하다 ;중계, 릴레이 경주, 계주
float: 뜨다, 미끄러지듯 걷다
ashamed: 부끄러워하는, 창피한
comfort: 안락함, 위로 ; 위로하다
distinguish: 구별하다, 구분하다
utterance: (입으로 한) 말, 발언,(말로) 표현함
arouse: 자극하다, 환기시키다
discriminate: 구별하다, 차별하다
arithmetic: 산수, 산술, 계산 ,산수의, 산술의
explicit: 명시적인, 분명한, 외현적인
cram: 밀어 쑤셔 넣다,벼락치기 하다 ; 벼락공부
burnout: 기력 쇠진, 신경 쇠약
tremendous: 엄청난, 굉장한, 대단한
morality: 도덕(성)
tension: 긴장
proponent: 옹호자, 지지자
arrest: 체포, 정지, 저지 ; 체포하다,저지하다
appeal: 호소하다, 간청하다 ;호소, 간청
culinary: 요리[음식]의
incubation: 배양, 부화, 잠복(기)
license: 라이선스, 면허, 허가, 인가
scope: (적용) 범위, 영역,(활동의) 기회
temporal: 시간의, 일시적인
chaotic: 무질서한, 혼란 상태인
simplicity: 단순함, 단순성
adherent: 신봉자, 추종자 , 들러붙는,부착하는
dedication: 헌신, 전념
theoretically: 이론적으로
acoustic: 전자 장치를 쓰지 않는,음향의, 청각의
withdraw: 끌어오다, 철수[철회]하다,인출하다
irrigation: 관개, 물을 끌어들임
spatially: 공간적으로
autonomy: 자율(성), 자치권
craftsman: 장인, 공예가, 기술자
livelihood: 생계, 살림
inadvertently: 의도치 않게, 무심코, 우연히
disturb: 방해하다, 건드리다,혼란 시키다
insurmountable: 극복할 수 없는,넘을 수 없는
intervene: 개입하다, 간섭하다,중재[조정]하다
monetary: 금전적인, 통화의, 화폐의
proactive: 주도적인, 솔선하는, 진취적인
indicative: ~을 보여 주는[나타내는],~의 표시인
commodity: 상품, 물품
obedient: 따르는, 순종적인, 복종하는
seduce: 유혹하다, 꾀다,매료[매혹]시키다
uniqueness: 독특함, 고유함
budget: 예산, 비용 ; 예산을 세우다
revenue: 수입, 수익, 세입
capitalist: 자본주의의 ; 자본주의자,자본가
archaeologist: 고고학자
infer: 추론하다, 추측하다, 암시하다
barter: 물물교환하다, 교역하다 ;물물교환, 교역
ambiguity: 모호함, 불분명함
diverge: 나뉘다, 갈라지다,빗나가다, 벗어나다
congruent: 동일한, 조화된, 일치하는
thrift: 절약, 검소
loan: 대출(금), 융자(금)
ape: 유인원
seemingly: 겉보기에, 외견상으로
interweave: 섞어 넣다, 섞어 짜다
pathological: 병리학적인, 병적인
differential: 차등적인, 차별적인 ;차이, 격차
cloning: 복제
convert: 전환하다, 개조하다,개종시키다 ; 개종한 사람
ecosystem: 생태계
pervasive: 만연한, 널리 퍼지는,침투하는
crude: 조잡한, 가공하지 않은
legitimize: 합법화하다
reluctant: 내키지 않는, 꺼리는,마지못한
paradigm: 이론[사고]의 틀, 패러다임,모범
subjective: 주관적인
affective: 정서적인, 감정적인
scrutiny: 유심히 살펴보기, 정밀 조사,감시
qualification: 능력, 자격 (조건), 권한
sphere: 영역, 범위, 구체
compensation: 보수, 보상, 배상
equity: 공정(성), 평등, 정당
ratio: 비(율)
manifest: 드러내다, 명백히 하다,증명하다 ; 분명한, 명백한
extent: 범위, 정도, 한도
generosity: 관대함, 넉넉함, 후함
safeguard: 안전하게 지키다, 보호하다 ;예방책, 안전장치, 보호
grocer: 식료품상, 식료품 잡화상
accommodation: 거처, 숙소, 숙박 시설
apologize: 사과하다, 사죄하다
heed: 주의를 기울이다, 조심하다 ;주의, 유의
detachment: 무심함, 거리를 둠, 분리
blossom: 꽃을 피우다, 번영[번성]하다 ;개화, 꽃, 전성기
underprivileged: 혜택을 받지 못하는, 권리를 누리지 못하는
enroll: 등록시키다, 입학시키다
enclose: 동봉하다, 둘러[에워]싸다
certificate: 증명서, 증서, 자격증
robe: 예복, 법복; ~을 입다[입히다]
struggle: 분투, 고투, 발버둥질, 몸부림; 힘겨워하다, 애쓰다
colloquial: 구어적인, 일상 회화의
watchdog: 감시(자), 감시 단체 ; 감시의
unbiased: 편견[선입견]이 없는
cultivate: 계발하다, 길러 주다,배양하다, 경작하다
habituation: 습관화
hybrid: 혼성의, 잡종의; 혼성체, 잡종
profession: 직업, 전문직, 공언
attorney: 변호사
semantic: 의미의, 의미론적인
subset: 부분 집합, 부분
discredit: 믿지 않다, 의심하다 ;불신(임), 의혹
mischievous: 해로운, 짓궂은,장난을 좋아하는
diabetes: 당뇨병
ethnic: 민족의, 인종의
haunting: 잊히지 않는,자주 마음에 떠오르는
container: 용기, 그릇, 컨테이너
classify: 분류하다, 구분하다
derive: 도출하다, 이끌어 내다,~에서 유래[파생]하다
orient: 적응시키다, 지향하게 하다,맞추다
swear: 증언하다, 맹세하다,욕을 하다
reciprocal: 상호적인, 호혜적인
rationalization: 합리화, 이론적 설명
represent: 나타내다, 표현하다,대표[대신]하다
violation: 위반, 위배, 방해, 침해
improvisational: 즉흥적인
explore: 탐구하다, 탐험하다, 탐사하다
vital: 중대한, 생명 유지와 관련된,활력이 넘치는
refute: 반박[논박]하다,~이 틀렸음을 밝히다
humiliate: 굴욕감을 주다, 창피를 주다
adversely: 부정적으로, 불리하게, 반대로
administer: 통치하다, 관리하다, 투약하다
glacier: 빙하
massive: 거대한, 엄청난, 심각한
texture: 감촉, 질감, 직물
expand: 팽창하다, 확대되다, 확장되다
upright: 똑바로, 꼿꼿이; 직립한,똑바로 선
output: 생산(량), 산출
achievement: 업적, 성취, 달성
complexity: 복잡성, 복잡함
tackle: 다루다, 맞서 싸우다,태클을 걸다
premium: 할증료, 프리미엄
fertilizer: 비료
herbicide: 제초제
apprentice: 수습생, 견습생, 도제 ;수습생[도제]으로 삼다
inhabitant: 주민, 거주자
laboratory: 연구소, 실험실
naturalist: 동식물 연구가, 박물학자
botany: 식물학
pipeline: 파이프라인, 체계
diversity: 다양성
speech:-writer 연설문 작성자
ambivalent: 상반된 감정이 공존하는,상반된
ubiquitous: 도처에 존재하는,어디서나 볼 수 있는
saltwater: 바닷물의 ; 바닷물, 소금물
onwards: (특정 시간부터) 계속
liberation: 해방
satire: 풍자, 풍자극
poetry: 시
voucher: 상품권, 쿠폰
aviation: 항공(술)
cancellation: 취소
gourmet: 미식가, 식도락가; 미식가의,미식가를 위한 요리용의
artisan: 장인, 숙련공
photocopy: 복사본 ; 복사하다
replication: 복제
condense: 압축하다
reliability: 신뢰성, 신뢰도
differentiation: 구분, 차별
investigate: 연구하다, 조사하다,(무슨 일인지) 알아보다
rigor: 엄격함, 엄밀함
reconcile: 화해시키다, 조화시키다
offset: 상쇄하다
predator: 포식자
kinship: 친족, 친족 체계
bloodstream: 혈류
sensory: 감각의, 감각에 의한
rationale: (근본적) 이유, (논리적) 근거
diligent: 부지런한
prospect: 가망, 전망
autograph: 사인을 해 주다; (자필)사인
tremble: 떨리다, 떨다
groundwork: 토대
cherish: 소중히 여기다
explode: 터지다, 폭발하다,폭발적으로 증가하다
throat: 목구멍
vow: 서약 ; 맹세하다, 서약하다
conviction: 확신, 유죄 선고[판결]
fridge: 냉장고
tendency: 경향
impulse: 충동적인 ; 충동
commander: 지휘관
continuation: 계속, 지속
constitutional: 헌법(상)의, 합헌의
transcend: 초월하다, 뛰어넘다
articulate: 분명히 표현하다[말하다]
apprenticeship: 도제 (제도)
ripen: 익다, 숙성하다
boast: 자랑할 만한; ~을 갖고 있다,자랑하다
degradation: 질적 저하, 악화
sympathy: 동정
intent: 의도; 여념이 없는, 열심인
ethics: 윤리학
frailty: 허약함
enterprise: 산업, 기업
soar: 날아오르다, 치솟다, 급등하다
beak: 부리
outlet: 매장, 분출구
minimum: 최소한의 ; 최소한도, 최소한
vendor: 노점상
resemble: 닮다
column: 세로 단, 칼럼, 기고란, 기둥
savor: 음미하다 ; 맛, 풍미
indiscernible: 분간하기 어려운
retrieve: 생각해 내다, 불러오다
microscope: 현미경
associate: 연관시키다, 관련시키다
define: 정의하다
fragmentation: 해체, 단편화
turnover: (자금, 상품의) 회전율,매출(액)
transaction: 거래, 교류
sacrifice: 대가, 희생
moisture: 습기, 수분
disguise: 위장하다 ; 변장, 위장
intersect: 교차하다
interpretation: 해석, 통역, 이해, 설명
defect: 결함
enact: 제정하다, 상연하다, 하다,일어나다
deploy: 활용하다, 배치하다
disregard: 무시, 묵살 ; 무시하다,묵살하다
infrastructure: 기반 시설, 사회 기반 시설
norm: 규범, 기준, 표준
prescriptive: 지시하는, 규범적인, 규정하는
emission: 방출, 배출(물), 배기가스
skeptical: 회의적인
delusion: 착각, 오해, 망상
fictive: 허구의, 가공의
cruise: 돌아다니다, 순항하다 ;유람선 여행
gallop: 질주하다, 전속력으로 달리다
maturity: 성숙(도), 원숙함
aglow: 환히 빛나는, 벌건, 흥분한
expound: 상세히 설명하다
dictate: 지시하다, 명령하다, 좌우하다,받아쓰게 하다 ; 지시, 명령
characterize: 특징짓다, 특성을 기술하다
subject: ~될[당할] 수 있는 ; 주제,과목, 대상, 피실험자, 국민
preference: 편애, 선호(도)
subsidy: 보조금, 장려금
sluggish: 느린, 부진한, 불경기의
cylindrical: 원통형의
solitude: 고독, 외로움
demolish: 철거하다, 무너뜨리다, 허물다
consist: (부분, 요소로) 구성되다[이루어져 있다]
durable: 튼튼한, 내구성이 있는
treasure: 간직하다, 소중히 여기다 ;보물
complement: 보완하다, 보충하다
mobility: 이동성, 기동성
cluster: 모이게 하다, 모이다 ;(포도 등의) 송이, 떼, 무리
dispersed: 분산된, 흩어진
endeavor: 시도, 노력 ; 노력하다
biography: 전기(문)
pronounce: 표명하다, 선언하다, 발음하다
coherent: 일관성 있는, 일치하는
interstellar: 별과 별 사이의, 성간의
astrobiology: 우주생물학
advance: 촉진하다, 발전하다 ;발전, 전진
pavement: 노면, 포장 도로
respiratory: 호흡의
precision: 정확성, 정확도
correspond: 상응하다, 일치하다,서신을 주고받다
grooming: 털 손질, 차림새, 몸단장
practitioner: 실무자, 개업한 의사[변호사]
longitudinal: 장기적인, 세로의, 경도의
obese: 비만인, 비만의
biopsychological: 생체 심리학의
vertebrate: 척추동물
outwit: ~보다 한 수 앞서다
fling: 내던지다, 팽개치다
unhook: (잠금 장치를) 풀다,떼어 내다
vibrant: 강렬한, 생기가 넘치는
intersection: 교차로
dampness: 축축함, 눅눅함
overtake: (재난 등이) 덮치다, 추월하다
apprehension: 불안, 우려, 이해(력)
permeate: 스며들다, 침투하다
fatalism: 숙명[운명]론
catastrophic: 대재앙의, 비극적인, 파멸의
peril: 위험 ; 위험에 빠뜨리다
meditate: 명상하다
coverage: 보도, 취재, 보상 범위
devote: 바치다, 할애하다, 쏟다,헌납하다
modulation: 조정, 조절
predominantly: 대부분, 대개
hemisphere: (뇌, 지구 등의) 반구
posture: 자세
autonomic: 자율의, 자치의
doctorate: 박사 학위
novice: 초보자
acute: 예리한, (질병이) 급성의
solidify: 확고히 하다, 굳히다
perseverance: 인내(력)
scholarship: 학문, 장학금
found: 세우다, 설립하다
subtraction: 삭감, 뺄셈, 빼기
approach: 접근법 ; 다가가다, 접근하다
physiological: 생리적인, 생리학의
consistency: 일관성, 한결같음
reciprocate: 보답하다
donor: 기부자, 기증자
recipient: 수령인, 수신인
uneven: 공평하지 않은, 불균일한,평평하지 않은
artifact: 공예품, 인공 유물
measurement: 측정, 측량, 치수
subconsciously: 잠재의식적으로
allocation: 배분, 할당
nuisance: 불법 방해, 성가심,성가신 사람
scheme: 제도, 체계, 계획
disposition: 성향, 기질
presumably: 아마, 짐작건대
conformist: 동조[순응]적인, 순응주의자
maladaptive: 적응하지 못하는, 부적응의
prosocial: 친 사회적인
altruistic: 이타적인
authorized: 인정받은, 인가 받은,권한이 있는
aspirant: 열망자, 지망생
candid: 솔직한, 숨김없는
brilliant: 눈부신, 뛰어난, 훌륭한, 멋진
ruthless: 무자비한, 잔인한, 가차 없는
afford: 여유[형편]가 되다,~할 수 있다
affection: 애정, 애착
flush: 물로 씻어 내리다,홍조를 띠다
unsanitary: 비위생적인
midterm: 중간고사, (학기 , 임기 등의)중간의
reschedule: 일정을 변경하다
variety: 품종, 다양성, 다양함
toxic: 유독성의, 해로운
expired: 기한이 지난, 만료된
pharmacy: 약국, 약학
aisle: 통로, 길
guidance: 안내, 지도
available: 이용 가능한, 얻을 수 있는,구입이 가능한, 시간이 있는
demonstrate: 보여 주다, 입증하다,시위에 참가하다
distribution: 분포, 배급, 배부, 유통
rearrange: 재배치하다, 재조정하다,재배열하다
striped: 줄무늬의
houseplant: 실내용 화초
sculpture: 조각(상), 조각품
sprain: (팔목, 발목을) 삐다,접질리다
recommend: 추천하다, 권하다, 권장하다
prohibit: 금지하다, 못하게 하다
glue: 접착제, (접착제로) 붙이다
receipt: 영수증
edible: 먹을 수 있는, 식용의
impersonal: 인간미가 없는, 비인격적인
humid: 습한
immune: 면역의
itchy: 가려운
exposure: 노출
utility: (수도, 전기 가스 등의)공공요금, 공익사업, 유용성
carve: 조각하다, 분할하다,베어 나누다
exhibition: 전시(회)
inspire: 고무시키다, 영감을 주다
sightseeing: 관광, 유람
soak: 담그다, 흡수하다,흠뻑 적시다
celebrity: 유명인, 명성
costume: 의상, 복장
unlock: (자물쇠를) 열다, 드러내다,(비밀 등을) 털어놓다
flyer: (광고용) 전단, 비행기 이용객[승객], 비행사
lettuce: 양상추, 상추
detergent: 세제, 세정제
valid: 유효한, 타당한
miniature: 축소 모형, 소형의,아주 작은
muscular: 근육의, 근육질의
session: 수업 (시간), (의회의) 희기
architectural: 건축(학)의
pillar: 기둥
recipe: 요리법
showcase: 소개하다, 선보이다, 전시하다
attendee: 참석자
upcoming: 다가오는
admission: 입장(료), 인정, 입학
annual: 연례의, 연간의, 매년의
maze: 미로
district: 지역, 지대, 지구
feature: 포함하다, 특징으로 삼다 ;특징, 이목구비, 특집
collision: 충돌
pricy: 비싼
fix: 고치다, 수리하다, 고정시키다
hut: 산장, 오두막
permit: 허용하다, 허가하다, 허가증
climate: 기후
moist: 촉촉한, 습기 있는
overflow: (물 등이) 넘치다[넘쳐흐르다],(사람들로) 넘쳐 나다
range: 범위, 다양성 ; 다양하다,~의 범위에 걸치다
insurance: 보험, 보험업, 보험금
ankle: 발목
lower: 낮추다, 내리다
swollen: 부어 오른
coworker: 동료, 함께 일하는 사람
replace: 교체하다, 대신하다, 바꾸다
text: 문자 메시지, 글, 문서, 교재 ,(휴대 전화로) 문자를 보내다
fault: 잘못, 실수, 결함, 비난하다,나무라다
concentrate: 집중하다
awareness: 의식, 인식
garbage: 쓰레기, 쓰레기장
rotten: 부패한, 썩은
presentation: 발표, 표현, 제출
format: 형식, 구성 방식
option: 선택(권), (기기의) 옵션
fever: 열, 신열
pollen: 꽃가루
rash: 발진
medical: 건강 진단의, 의학의
routine: 일상적인 일, 일과일상적인, 정례적인
carton: (음식이나 음료를 담는)통[갑], 상자
spill: 쏟아지다, 흘리다 유출, 흘림,엎지름
assignment: 과제, 임무, 배정
invention: 발명(품), 창의력, 독창성
recycling: 재활용
memorize: 외우다, 기억하다, 암기하다
crack: (갈라져 생긴) 금,금이 가다, 갈라지다
faucet: 수도꼭지
plumber: 배관공
extend: 연장하다, 확장하다
stuff: (빽빽이) 채워 넣다 물건
booth: 부스, (칸막이를 한)작은 공간
decline: 거절하다, 쇠퇴하다, 감소하다쇠퇴, 감소
colleague: 동료
concerned: 걱정하는, 관심이 있는
interact: 교류하다, 상호 작용하다
capture: 잡다, 포획하다, 사로잡다
dandelion: 민들레
goodwill: 호의, 선의
stir: 자극하다, 부추기다, 휘젓다
trustworthy: 믿을 수 있는,신뢰할 수 있는
compound: 화합물, 복합체 ,섞다, 혼합하다
density: 밀도, 농도
inflammation: (신체 부위의) 염증
basement: 지하실, 지하층
reunion: 동창회, 친목 모임, 재회
procrastination: 미루기, 미루는 버릇,꾸물거림, 지연
enhance: 향상시키다, 강화하다
renovation: 보수 (작업), 수리, 혁신
stationery: 문구류, 문방구
exchange: 교환하다, 교류, 교환, 환전
flattering: 기쁘게 하는, 아첨하는
cordless: 무선의
accompany: 동반하다, 동행하다,반주를 하다
hospitalize: 입원시키다
infectious: 전염성의
prop: (연극, 영화)소품, 버팀목,(받침대 등으로) 받치다
venue: (콘서트, 경기 , 회담 등의)(개최) 장소
authentic: 정통의, 진정한, 진짜의
cuisine: 요리, 요리법
draft: (아직 완성본이 아닌) 초고,초안, 밑그림
mandatory: 의무적인, 강제적인, 명령의
mind:-set 태도, 사고방식
appliance: 가전제품, 적용, 응용
utensil: 기구, 가정용품
outdated: 구식의
enthusiastic: 열정적인, 열렬한, 열광적인
bulb: 구, 공 모양의 물건, 전구
rating: 평가, 등급
observance: (법률, 규칙 등의) 준수,(축제, 생일 등의) 축하
warranty: (제품 등의) 보증, (제품의) 품질 보증서
symbolize: 상징하다
shovel: 삽 , 삽질하다
stimulate: 자극하다, 격려하다
pedestrian: 보행자
auditorium: 강당, 청중석
initiate: 입문시키다, 시작하다,가입시키다
vine: 덩굴, 덩굴 식물, 포도나무
breakdown: (차량 기계의) 고장, 붕괴
identical: 똑같은, 동일한
commute: 통근 , 통근하다
accommodate: (요구 등을) 받아들이다,수용하다, 공간을 제공하다
property: 속성, 재산
remedy: 요법, 치료(법), 해결책
label: 분류하다, ~라고 부르다,~에 라벨을 붙이다 ; 표, 라벨
crave: 간절히 원하다, 열망하다
organize: 정리하다, 구성하다, 조직하다
greenery: 화초, 푸른 잎[나무]
misplace: 둔 곳을 잊다,제자리에 두지 않다
conference: 학회, 회의, 회담
tangible: 실체적인, 유형의
notorious: 악명 높은
toll: 통행료, 대가, 사상자
departure: 출발
confess: 고백하다, 자백하다, 인정하다
abolish: (법, 세금, 제도 등을)폐지하다
ointment: 연고
physician: 의사, 내과 의사
driveway: 진입로
intermediate: 중급의, 중간 수준의
precaution: 예방 조치, 예방책
lean: 기대 놓다, 숙이다, 굽히다
mimic: 흉내 내다, 모방하다
tease: 놀리다, 못살게 굴다
stubborn: 고집스러운, 완고한
caffeinated: 카페인이 함유된
strap: 끈, 줄
volunteer: 자원봉사(자), 자원봉사하다
rural: 시골의, 지방의
hive: 벌통, 벌집
endangered: 멸종 위기에 처한
drought: 가뭄
aquaculture: 수산 양식, 수경재배
reproduction: 번식, 재현, 재생산